{
    "levels": [
        {
            "level": 1,
            "rows": 10,
            "cols": 10,
            "grid": [
                "1,1,1,1,1,1,1,1,1,1",
                "1,1,1,1,1,1,1,1,1,1",
                "1,1,1,1,1,1,1,1,1,1",
                "1,1,1,1,1,1,1,1,1,1",
                "1,1,1,1,1,1,1,1,1,1",
                "1,1,1,1,1,1,1,1,1,1",
                "1,1,1,1,1,1,1,1,1,1",
                "1,1,1,1,1,1,1,1,1,1",
                "1,1,1,1,1,1,1,1,1,1",
                "1,1,1,1,1,1,1,1,1,1"
            ],
            "moves": 24,
            "objective": ["12;blue","12;red","12;yellow"]
        },
        {
            "level": 2,
            "rows": 7,
            "cols": 7,
            "grid": [
                "1,1,1,1,1,1,1",
                "X,1,1,1,1,1,X",
                "1,1,1,1,1,1,1",
                "X,1,1,1,1,1,X",
                "1,1,1,1,1,1,1",
                "X,1,1,1,1,1,X",
                "1,1,1,1,1,1,1"
            ],
            "moves": 24,
            "objective": ["9;green","9;purple","9;orange"]
        },
        {
            "level": 3,
            "rows": 10,
            "cols": 10,
            "grid": [
                "X,1,1,X,X,X,X,X,1,X",
                "1,1,1,1,1,1,1,1,1,1",
                "X,1,1,1,1,1,1,1,1,X",
                "1,1,1,W,1,1,W,1,1,1",
                "1,1,1,W,1,1,W,1,1,1",
                "1,1,1,W,1,1,W,1,1,1",
                "X,1,1,W,1,1,W,1,2,X",
                "1,1,1,1,1,1,1,1,2,1",
                "1,1,1,1,1,1,1,1,1,1",
                "X,1,1,X,X,X,X,1,1,X"
            ],
            "moves": 24,
            "objective": ["9;blue","15;red","9;purple"]
        },
        {
            "level": 4,
            "rows": 10,
            "cols": 10,
            "grid": [
                "X,1,1,X,X,X,X,1,1,X",
                "1,1,1,1,1,1,1,1,1,1",
                "X,2,1,1,1,1,1,1,2,X",
                "1,2,1,W,1,1,W,1,2,1",
                "1,1,1,1,1,1,1,1,1,1",
                "1,1,1,1,1,1,1,1,1,1",
                "X,2,1,W,1,1,W,1,2,X",
                "1,2,1,1,1,1,1,1,2,1",
                "1,1,1,1,1,1,1,1,1,1",
                "X,1,1,X,X,X,X,1,1,X"
            ],
            "moves": 20,
            "objective": ["10;blue","10;yellow","10;green","10;orange"]
        },
        {
            "level": 5,
            "rows": 5,
            "cols": 5,
            "grid": [
                "X,1,X,1,X",
                "X,1,1,1,X",
                "1,1,W,1,1",
                "X,1,1,1,X",
                "X,1,X,1,X"
            ],
            "moves": 24,
            "objective": ["9;green","9;red","9;yellow"]
        }
    ]
}